"filename", "language", "TypeScript JSX", "TypeScript", "comment", "blank", "total"
"d:\share12\three-template-master\src\table\calculate.ts", "TypeScript", 0, 205, 28, 15, 248
"d:\share12\three-template-master\src\table\calculateType.ts", "TypeScript", 0, 14, 0, 2, 16
"d:\share12\three-template-master\src\table\checkboxColumn.ts", "TypeScript", 0, 153, 10, 1, 164
"d:\share12\three-template-master\src\table\column.ts", "TypeScript", 0, 864, 35, 4, 903
"d:\share12\three-template-master\src\table\columnConfig.ts", "TypeScript", 0, 57, 2, 3, 62
"d:\share12\three-template-master\src\table\editor\baseEdit.ts", "TypeScript", 0, 29, 0, 2, 31
"d:\share12\three-template-master\src\table\editor\string.ts", "TypeScript", 0, 138, 10, 9, 157
"d:\share12\three-template-master\src\table\editor\tableInput.tsx", "TypeScript JSX", 125, 0, 2, 1, 128
"d:\share12\three-template-master\src\table\registerEdit.ts", "TypeScript", 0, 15, 1, 3, 19
"d:\share12\three-template-master\src\table\table.ts", "TypeScript", 0, 1338, 41, 2, 1381
"d:\share12\three-template-master\src\table\tableButtonCom.tsx", "TypeScript JSX", 89, 0, 5, 2, 96
"d:\share12\three-template-master\src\table\tableCom.tsx", "TypeScript JSX", 294, 0, 17, 1, 312
"d:\share12\three-template-master\src\table\tableData.ts", "TypeScript", 0, 12194, 14, 6, 12214
"d:\share12\three-template-master\src\table\tableEvent.ts", "TypeScript", 0, 287, 15, 11, 313
"d:\share12\three-template-master\src\table\tableFilterCom.tsx", "TypeScript JSX", 122, 0, 3, 2, 127
"d:\share12\three-template-master\src\table\tableMenuCom.tsx", "TypeScript JSX", 15, 0, 9, 2, 26
"d:\share12\three-template-master\src\table\tableTheme.ts", "TypeScript", 0, 234, 0, 5, 239
"Total", "-", 645, 15528, 192, 71, 16436